11111111111111111111111311111111111111111111111111
10000000000000000000000308888888808000000000000001
10000000000000000000000308888888888000000000000001
10000000000000000000000308800080808000000000000001
10000000000000000000000308808000800000000000000001
10000000000000000000000300000000000000000000000001
10000000000000000000000300000000000000000000000001
10000000000000000000000300000000000000000000000001
10000000000000000000000300000000000000000000000001
10000000000000000000000300000000000000000000000001
10000000000000000000000300000000000000000000000001
10000000000000000000000300000000000000000000000001
10000000000000000000000300000000000000000000000001
10000000000000000000000300000000000000000000000001
10000000000000000000000300000000000000000000000001
10000000000000000000000300000000000000000000000001
10000000000000000000000300000000000000000000000001
10000000000000000000000300000000000000000000000001
10000000000000000000000300000000000000000000000001
10000000000000000000000300000000000000000000000001
10000000000000000000000300000000000000000000000001
10000000000000000000000300000000000000000000000001
10000000000000000000000300000000000000000000000001
10000000000000000000000300000000000000000000000001
10000000000000000000000300000000000000000000000001
10000000000000000000000300000000000000000000000001
10000000000000000000000300000000000000000000000001
10000000000000000000000300000000000000000000000001
10000000000000000000000300000000000000000000000001
10000000000000000000000300000000000000000000000001
10000000000000000000000300000000000000000000000001
10000000000000000000000300000000000000000000000001
10000000000000000000000300000000000000000000000001
10000000000000000000000300000000000000000000000001
10000000000000000000000300000000000000000000000001
10000000000000000000000300000000000000000000000001
10000000000000000000000300000000000000000000000001
10000000000000000000000300000000000000000000000001
10000000000000000000000300000000000000000000000001
10000000000000000000000300000000000000000000000001
10000000000000000000000300000000000000000000000001
10000000000000000000000300000000000000000000000001
10000000000000000000000300000000000000000000000001
10000000000000000000000300000000000000000000000001
10000000000000000000000300000000000000000000000001
10000000000000000000000300000000000000000000000001
10000000000000000000000300000000000000000000000001
10000000000000000000000300000000000000000000000001
10000000000000000000000300000000000000000000000001
11111111111111111111111111111111111111111111111111